slot	range	domain	range_is_nmdc_class
abs_air_humidity	QuantityValue	Biosample	True
add_date	string	Biosample, DataGeneration, MassSpectrometry, NucleotideSequencing	False
add_recov_method	TextValue	Biosample	True
additional_info	TextValue	Biosample	True
address	TextValue	Biosample	True
adj_room	TextValue	Biosample	True
aero_struc	TextValue	Biosample	True
agrochem_addition	TextValue	Biosample	True
air_PM_concen	TextValue	Biosample	True
air_temp	QuantityValue	Biosample	True
air_temp_regm	TextValue	Biosample	True
al_sat	QuantityValue	Biosample	True
al_sat_meth	TextValue	Biosample	True
alkalinity	QuantityValue	Biosample	True
alkalinity_method	TextValue	Biosample	True
alkyl_diethers	QuantityValue	Biosample	True
alt	QuantityValue	Biosample	True
alternative_descriptions	string	Study	False
alternative_identifiers	uriorcurie	Biosample, CalibrationInformation, ChemicalConversionProcess, ChemicalEntity, ChromatographicSeparationProcess, ChromatographyConfiguration, CollectingBiosamplesFromSite, Configuration, DataGeneration, DataObject, DissolvingProcess, EnvironmentalMaterialTerm, Extraction, FieldResearchSite, FiltrationProcess, FunctionalAnnotationTerm, GeneProduct, InformationObject, Instrument, LibraryPreparation, MagsAnalysis, Manifest, MassSpectrometry, MassSpectrometryConfiguration, MaterialEntity, MaterialProcessing, MetaboliteIdentification, MetabolomicsAnalysis, MetagenomeAnnotation, MetagenomeAssembly, MetagenomeSequencing, MetaproteomicsAnalysis, MetatranscriptomeAnnotation, MetatranscriptomeAssembly, MetatranscriptomeExpressionAnalysis, MixingProcess, NamedThing, NomAnalysis, NucleotideSequencing, OntologyClass, OrthologyGroup, Pathway, PlannedProcess, Pooling, ProcessedSample, ReadBasedTaxonomyAnalysis, ReadQcAnalysis, Sample, Site, StorageProcess, Study, SubSamplingProcess, WorkflowExecution	False
alternative_names	string	ChemicalEntity, EnvironmentalMaterialTerm, FunctionalAnnotationTerm, OntologyClass, OrthologyGroup, Pathway, Study	False
alternative_titles	string	Study	False
aminopept_act	QuantityValue	Biosample	True
ammonium	QuantityValue	Biosample	True
ammonium_nitrogen	QuantityValue	Biosample	True
amount_light	QuantityValue	Biosample	True
analysis_type	AnalysisTypeEnum	Biosample	False
analyte_category	MassSpectrometryEnum	MassSpectrometry	False
analyte_category	NucleotideSequencingEnum	NucleotideSequencing	False
analyte_category	string	DataGeneration	False
ances_data	TextValue	Biosample	True
annual_precpt	QuantityValue	Biosample	True
annual_temp	QuantityValue	Biosample	True
antibiotic_regm	TextValue	Biosample	True
api	QuantityValue	Biosample	True
applied_roles	CreditEnum	CreditAssociation	False
applies_to_person	PersonValue	CreditAssociation	True
arch_struc	arch_struc_enum	Biosample	False
aromatics_pc	TextValue	Biosample	True
asm_score	float	MetagenomeAssembly, MetatranscriptomeAssembly	False
asphaltenes_pc	TextValue	Biosample	True
associated_dois	Doi	Study	True
associated_studies	Study	Biosample, DataGeneration, MassSpectrometry, NucleotideSequencing	True
atmospheric_data	TextValue	Biosample	True
avg_dew_point	QuantityValue	Biosample	True
avg_occup	TextValue	Biosample	True
avg_temp	QuantityValue	Biosample	True
bac_prod	QuantityValue	Biosample	True
bac_resp	QuantityValue	Biosample	True
bacteria_carb_prod	QuantityValue	Biosample	True
barometric_press	QuantityValue	Biosample	True
basin	TextValue	Biosample	True
bathroom_count	TextValue	Biosample	True
bedroom_count	TextValue	Biosample	True
benzene	QuantityValue	Biosample	True
bin_name	string	MagBin	False
bin_quality	BinQualityEnum	MagBin	False
binned_contig_num	integer	MagsAnalysis	False
biochem_oxygen_dem	QuantityValue	Biosample	True
biocide	TextValue	Biosample	True
biocide_admin_method	TextValue	Biosample	True
biol_stat	biol_stat_enum	Biosample	False
biomass	TextValue	Biosample	True
biomaterial_purity	QuantityValue	ProcessedSample	True
biosample_categories	BiosampleCategoryEnum	Biosample	False
biosample_set	Biosample	Database	True
biotic_regm	TextValue	Biosample	True
biotic_relationship	biotic_relationship_enum	Biosample	False
bishomohopanol	QuantityValue	Biosample	True
blood_press_diast	QuantityValue	Biosample	True
blood_press_syst	QuantityValue	Biosample	True
bromide	QuantityValue	Biosample	True
build_docs	build_docs_enum	Biosample	False
build_occup_type	build_occup_type_enum	Biosample	False
building_setting	building_setting_enum	Biosample	False
built_struc_age	QuantityValue	Biosample	True
built_struc_set	TextValue	Biosample	True
built_struc_type	TextValue	Biosample	True
bulk_elect_conductivity	QuantityValue	Biosample	True
calcium	QuantityValue	Biosample	True
calibration_object	DataObject	CalibrationInformation	True
calibration_set	CalibrationInformation	Database	True
calibration_standard	CalibrationStandardEnum	CalibrationInformation	False
calibration_target	CalibrationTargetEnum	CalibrationInformation	False
carb_dioxide	QuantityValue	Biosample	True
carb_monoxide	QuantityValue	Biosample	True
carb_nitro_ratio	QuantityValue	Biosample	True
ceil_area	QuantityValue	Biosample	True
ceil_cond	ceil_cond_enum	Biosample	False
ceil_finish_mat	ceil_finish_mat_enum	Biosample	False
ceil_struc	TextValue	Biosample	True
ceil_texture	ceil_texture_enum	Biosample	False
ceil_thermal_mass	QuantityValue	Biosample	True
ceil_type	ceil_type_enum	Biosample	False
ceil_water_mold	TextValue	Biosample	True
chem_administration	ControlledTermValue	Biosample	True
chem_mutagen	TextValue	Biosample	True
chem_oxygen_dem	QuantityValue	Biosample	True
chem_treat_method	string	Biosample	False
chem_treatment	TextValue	Biosample	True
chemical_conversion_category	ChemicalConversionCategoryEnum	ChemicalConversionProcess	False
chemical_formula	string	ChemicalEntity	False
chloride	QuantityValue	Biosample	True
chlorophyll	QuantityValue	Biosample	True
chromatographic_category	ChromatographicCategoryEnum	ChromatographicSeparationProcess, ChromatographyConfiguration	False
climate_environment	TextValue	Biosample	True
collected_from	FieldResearchSite	Biosample	True
collecting_biosamples_from_site_set	CollectingBiosamplesFromSite	Database	True
collection_date	TimestampValue	Biosample	True
collection_date_inc	string	Biosample	False
collection_time	string	Biosample	False
collection_time_inc	string	Biosample	False
community	string	Biosample	False
completeness	float	EukEval, MagBin	False
compression_type	string	DataObject	False
conditionings	string	FiltrationProcess	False
conduc	QuantityValue	Biosample	True
configuration_set	Configuration	Database	True
contained_in	ContainerCategoryEnum	StorageProcess, SubSamplingProcess	False
container_size	QuantityValue	FiltrationProcess, SubSamplingProcess	True
contamination	float	EukEval, MagBin	False
contig_bp	float	MetagenomeAssembly, MetatranscriptomeAssembly	False
contigs	float	MetagenomeAssembly, MetatranscriptomeAssembly	False
cool_syst_id	TextValue	Biosample	True
core field	string	Biosample	False
count	integer	FunctionalAnnotationAggMember	False
crop_rotation	TextValue	Biosample	True
ctg_l50	float	MetagenomeAssembly, MetatranscriptomeAssembly	False
ctg_l90	float	MetagenomeAssembly, MetatranscriptomeAssembly	False
ctg_logsum	float	MetagenomeAssembly, MetatranscriptomeAssembly	False
ctg_max	float	MetagenomeAssembly, MetatranscriptomeAssembly	False
ctg_n50	float	MetagenomeAssembly, MetatranscriptomeAssembly	False
ctg_n90	float	MetagenomeAssembly, MetatranscriptomeAssembly	False
ctg_powsum	float	MetagenomeAssembly, MetatranscriptomeAssembly	False
cult_root_med	TextValue	Biosample	True
cur_land_use	cur_land_use_enum	Biosample	False
cur_vegetation	TextValue	Biosample, FieldResearchSite	True
cur_vegetation_meth	TextValue	Biosample	True
data_category	DataCategoryEnum	DataObject	False
data_generation_set	DataGeneration	Database	True
data_object_set	DataObject	Database	True
data_object_type	FileTypeEnum	DataObject	False
date_last_rain	TimestampValue	Biosample	True
definition	string	ChemicalEntity, EnvironmentalMaterialTerm, FunctionalAnnotationTerm, OntologyClass, OrthologyGroup, Pathway	False
density	QuantityValue	Biosample	True
depos_env	depos_env_enum	Biosample	False
depth	QuantityValue	Biosample	True
description	string	Biosample, CalibrationInformation, ChemicalConversionProcess, ChemicalEntity, ChromatographicSeparationProcess, ChromatographyConfiguration, CollectingBiosamplesFromSite, Configuration, DataGeneration, DataObject, DissolvingProcess, EnvironmentalMaterialTerm, Extraction, FieldResearchSite, FiltrationProcess, FunctionalAnnotationTerm, GeneProduct, ImageValue, InformationObject, Instrument, LibraryPreparation, MagsAnalysis, Manifest, MassSpectrometry, MassSpectrometryConfiguration, MaterialEntity, MaterialProcessing, MetabolomicsAnalysis, MetagenomeAnnotation, MetagenomeAssembly, MetagenomeSequencing, MetaproteomicsAnalysis, MetatranscriptomeAnnotation, MetatranscriptomeAssembly, MetatranscriptomeExpressionAnalysis, MixingProcess, NamedThing, NomAnalysis, NucleotideSequencing, OntologyClass, OrthologyGroup, Pathway, PlannedProcess, Pooling, ProcessedSample, ReadBasedTaxonomyAnalysis, ReadQcAnalysis, Sample, Site, StorageProcess, Study, SubSamplingProcess, WorkflowExecution	False
dew_point	QuantityValue	Biosample	True
diether_lipids	TextValue	Biosample	True
display_order	integer	ImageValue	False
diss_carb_dioxide	QuantityValue	Biosample	True
diss_hydrogen	QuantityValue	Biosample	True
diss_inorg_carb	QuantityValue	Biosample	True
diss_inorg_nitro	QuantityValue	Biosample	True
diss_inorg_phosp	QuantityValue	Biosample	True
diss_iron	QuantityValue	Biosample	True
diss_org_carb	QuantityValue	Biosample	True
diss_org_nitro	QuantityValue	Biosample	True
diss_oxygen	QuantityValue	Biosample	True
diss_oxygen_fluid	QuantityValue	Biosample	True
dna_absorb1	float	Biosample, ProcessedSample	False
dna_absorb2	float	Biosample	False
dna_collect_site	string	Biosample	False
dna_concentration	float	Biosample, ProcessedSample	False
dna_cont_type	JgiContTypeEnum	Biosample	False
dna_cont_well	string	Biosample	False
dna_container_id	string	Biosample	False
dna_dnase	YesNoEnum	Biosample	False
dna_isolate_meth	string	Biosample	False
dna_organisms	string	Biosample	False
dna_project_contact	string	Biosample	False
dna_samp_id	string	Biosample	False
dna_sample_format	DNASampleFormatEnum	Biosample	False
dna_sample_name	string	Biosample	False
dna_seq_project	string	Biosample	False
dna_seq_project_name	string	Biosample	False
dna_seq_project_pi	string	Biosample	False
dna_volume	float	Biosample	False
dnase_rna	YesNoEnum	Biosample	False
doi_category	DoiCategoryEnum	Doi	False
doi_provider	DoiProviderEnum	Doi	False
doi_value	uriorcurie	Doi	False
door_comp_type	door_comp_type_enum	Biosample	False
door_cond	door_cond_enum	Biosample	False
door_direct	door_direct_enum	Biosample	False
door_loc	door_loc_enum	Biosample	False
door_mat	door_mat_enum	Biosample	False
door_move	door_move_enum	Biosample	False
door_size	QuantityValue	Biosample	True
door_type	door_type_enum	Biosample	False
door_type_metal	door_type_metal_enum	Biosample	False
door_type_wood	door_type_wood_enum	Biosample	False
door_water_mold	TextValue	Biosample	True
down_par	QuantityValue	Biosample	True
drainage_class	drainage_class_enum	Biosample	False
drawings	drawings_enum	Biosample	False
duration	QuantityValue	ChemicalConversionProcess, DissolvingProcess, MixingProcess, MobilePhaseSegment	True
ecosystem	string	Biosample, Study	False
ecosystem_category	string	Biosample, Study	False
ecosystem_subtype	string	Biosample, Study	False
ecosystem_type	string	Biosample, Study	False
efficiency_percent	QuantityValue	Biosample	True
elev	float	Biosample, FieldResearchSite	False
elevator	TextValue	Biosample	True
eluent_introduction_category	EluentIntroductionCategoryEnum	MassSpectrometry	False
email	string	PersonValue	False
embargoed	boolean	Biosample	False
emsl_biosample_identifiers	external_identifier	Biosample	False
emsl_project_identifiers	external_identifier	Study	False
emulsions	TextValue	Biosample	True
encodes	GeneProduct	GenomeFeature	True
end	integer	GenomeFeature	False
end_date	string	ChemicalConversionProcess, ChromatographicSeparationProcess, CollectingBiosamplesFromSite, DataGeneration, DissolvingProcess, Extraction, FiltrationProcess, LibraryPreparation, MagsAnalysis, MassSpectrometry, MaterialProcessing, MetabolomicsAnalysis, MetagenomeAnnotation, MetagenomeAssembly, MetagenomeSequencing, MetaproteomicsAnalysis, MetatranscriptomeAnnotation, MetatranscriptomeAssembly, MetatranscriptomeExpressionAnalysis, MixingProcess, NomAnalysis, NucleotideSequencing, PlannedProcess, Pooling, ReadBasedTaxonomyAnalysis, ReadQcAnalysis, StorageProcess, SubSamplingProcess, WorkflowExecution	False
ended_at_time	string	MagsAnalysis, MetabolomicsAnalysis, MetagenomeAnnotation, MetagenomeAssembly, MetagenomeSequencing, MetaproteomicsAnalysis, MetatranscriptomeAnnotation, MetatranscriptomeAssembly, MetatranscriptomeExpressionAnalysis, NomAnalysis, ReadBasedTaxonomyAnalysis, ReadQcAnalysis, WorkflowExecution	False
env_broad_scale	ControlledIdentifiedTermValue	Biosample	True
env_local_scale	ControlledIdentifiedTermValue	Biosample	True
env_medium	ControlledIdentifiedTermValue	Biosample	True
env_package	TextValue	Biosample	True
environment field	string	Biosample	False
escalator	TextValue	Biosample	True
ethylbenzene	QuantityValue	Biosample	True
eukaryotic_evaluation	EukEval	MagBin	True
execution_resource	ExecutionResourceEnum	MagsAnalysis, MetabolomicsAnalysis, MetagenomeAnnotation, MetagenomeAssembly, MetagenomeSequencing, MetaproteomicsAnalysis, MetatranscriptomeAnnotation, MetatranscriptomeAssembly, MetatranscriptomeExpressionAnalysis, NomAnalysis, ReadBasedTaxonomyAnalysis, ReadQcAnalysis, WorkflowExecution	False
exp_duct	QuantityValue	Biosample	True
exp_pipe	QuantityValue	Biosample	True
experimental_factor	ControlledTermValue	Biosample	True
experimental_factor_other	string	Biosample	False
ext_door	TextValue	Biosample	True
ext_wall_orient	ext_wall_orient_enum	Biosample	False
ext_window_orient	ext_window_orient_enum	Biosample	False
external_database_identifiers	external_identifier	ProcessedSample	False
extraction_targets	ExtractionTargetEnum	Extraction	False
extreme_event	string	Biosample	False
fao_class	fao_class_enum	Biosample	False
feature_category	ControlledIdentifiedTermValue	FunctionalAnnotation, GenomeFeature	True
feature_type	string	GenomeFeature	False
fertilizer_regm	TextValue	Biosample	True
field	TextValue	Biosample	True
field_research_site_set	FieldResearchSite	Database	True
file_size_bytes	bytes	DataObject	False
filter_material	string	FiltrationProcess	False
filter_method	string	Biosample	False
filter_pore_size	QuantityValue	FiltrationProcess	True
filter_type	filter_type_enum	Biosample	False
filtration_category	string	FiltrationProcess	False
final_concentration	QuantityValue	PortionOfSubstance	True
fire	string	Biosample	False
fireplace_type	TextValue	Biosample	True
flooding	string	Biosample	False
floor_age	QuantityValue	Biosample	True
floor_area	QuantityValue	Biosample	True
floor_cond	floor_cond_enum	Biosample	False
floor_count	TextValue	Biosample	True
floor_finish_mat	floor_finish_mat_enum	Biosample	False
floor_struc	floor_struc_enum	Biosample	False
floor_thermal_mass	QuantityValue	Biosample	True
floor_water_mold	floor_water_mold_enum	Biosample	False
fluor	QuantityValue	Biosample	True
freq_clean	QuantityValue	Biosample	True
freq_cook	QuantityValue	Biosample	True
functional_annotation_agg	FunctionalAnnotationAggMember	Database	True
functional_annotation_set	FunctionalAnnotation	Database	True
funding_sources	string	Study	False
fungicide_regm	TextValue	Biosample	True
furniture	furniture_enum	Biosample	False
gap_pct	float	MetagenomeAssembly, MetatranscriptomeAssembly	False
gaseous_environment	TextValue	Biosample	True
gaseous_substances	TextValue	Biosample	True
gc_avg	float	MetagenomeAssembly, MetatranscriptomeAssembly	False
gc_std	float	MetagenomeAssembly, MetatranscriptomeAssembly	False
gender_restroom	gender_restroom_enum	Biosample	False
gene_count	integer	MagBin	False
gene_function_id	uriorcurie	FunctionalAnnotationAggMember	False
generates_calibration	CalibrationInformation	MassSpectrometry	True
genetic_mod	TextValue	Biosample	True
genome_feature_set	GenomeFeature	Database	True
geo_loc_name	TextValue	Biosample, FieldResearchSite	True
git_url	string	MagsAnalysis, MetabolomicsAnalysis, MetagenomeAnnotation, MetagenomeAssembly, MetagenomeSequencing, MetaproteomicsAnalysis, MetatranscriptomeAnnotation, MetatranscriptomeAssembly, MetatranscriptomeExpressionAnalysis, NomAnalysis, ReadBasedTaxonomyAnalysis, ReadQcAnalysis, WorkflowExecution	False
glucosidase_act	QuantityValue	Biosample	True
gnps_task_identifiers	external_identifier	Study	False
gold_analysis_project_identifiers	external_identifier	MetagenomeAnnotation, MetatranscriptomeAnnotation	False
gold_biosample_identifiers	uriorcurie	Biosample	False
gold_sequencing_project_identifiers	external_identifier	NucleotideSequencing	False
gold_study_identifiers	external_identifier	Study	False
gravidity	TextValue	Biosample	True
gravity	TextValue	Biosample	True
growth_facil	ControlledTermValue	Biosample	True
growth_habit	growth_habit_enum	Biosample	False
growth_hormone_regm	TextValue	Biosample	True
gtdbtk_class	string	MagBin	False
gtdbtk_domain	string	MagBin	False
gtdbtk_family	string	MagBin	False
gtdbtk_genus	string	MagBin	False
gtdbtk_order	string	MagBin	False
gtdbtk_phylum	string	MagBin	False
gtdbtk_species	string	MagBin	False
habitat	string	Biosample, FieldResearchSite	False
hall_count	TextValue	Biosample	True
handidness	handidness_enum	Biosample	False
has_chromatography_configuration	ChromatographyConfiguration	MassSpectrometry	True
has_credit_associations	CreditAssociation	Study	True
has_failure_categorization	FailureCategorization	ChemicalConversionProcess, ChromatographicSeparationProcess, CollectingBiosamplesFromSite, DataGeneration, DissolvingProcess, Extraction, FiltrationProcess, LibraryPreparation, MagsAnalysis, MassSpectrometry, MaterialProcessing, MetabolomicsAnalysis, MetagenomeAnnotation, MetagenomeAssembly, MetagenomeSequencing, MetaproteomicsAnalysis, MetatranscriptomeAnnotation, MetatranscriptomeAssembly, MetatranscriptomeExpressionAnalysis, MixingProcess, NomAnalysis, NucleotideSequencing, PlannedProcess, Pooling, ReadBasedTaxonomyAnalysis, ReadQcAnalysis, StorageProcess, SubSamplingProcess, WorkflowExecution	True
has_function	string	FunctionalAnnotation	False
has_input	NamedThing	MagsAnalysis, MetabolomicsAnalysis, MetagenomeAnnotation, MetagenomeAssembly, MetagenomeSequencing, MetaproteomicsAnalysis, MetatranscriptomeAnnotation, MetatranscriptomeAssembly, MetatranscriptomeExpressionAnalysis, NomAnalysis, PlannedProcess, ReadBasedTaxonomyAnalysis, ReadQcAnalysis, StorageProcess, WorkflowExecution	True
has_input	Sample	ChemicalConversionProcess, ChromatographicSeparationProcess, DataGeneration, DissolvingProcess, Extraction, FiltrationProcess, LibraryPreparation, MassSpectrometry, MaterialProcessing, MixingProcess, NucleotideSequencing, Pooling, SubSamplingProcess	True
has_input	Site	CollectingBiosamplesFromSite	True
has_mass_spectrometry_configuration	MassSpectrometryConfiguration	MassSpectrometry	True
has_maximum_numeric_value	decimal	QuantityValue	False
has_metabolite_identifications	MetaboliteIdentification	MetabolomicsAnalysis	True
has_minimum_numeric_value	decimal	QuantityValue	False
has_numeric_value	decimal	QuantityValue	False
has_output	Biosample	CollectingBiosamplesFromSite	True
has_output	DataObject	DataGeneration, MassSpectrometry, NucleotideSequencing	True
has_output	NamedThing	MagsAnalysis, MetabolomicsAnalysis, MetagenomeAnnotation, MetagenomeAssembly, MetagenomeSequencing, MetaproteomicsAnalysis, MetatranscriptomeAnnotation, MetatranscriptomeAssembly, MetatranscriptomeExpressionAnalysis, NomAnalysis, PlannedProcess, ReadBasedTaxonomyAnalysis, ReadQcAnalysis, StorageProcess, WorkflowExecution	True
has_output	ProcessedSample	ChemicalConversionProcess, ChromatographicSeparationProcess, DissolvingProcess, Extraction, FiltrationProcess, LibraryPreparation, MaterialProcessing, MixingProcess, Pooling, SubSamplingProcess	True
has_raw_value	string	AttributeValue, ControlledIdentifiedTermValue, ControlledTermValue, GeolocationValue, ImageValue, PersonValue, QuantityValue, TextValue, TimestampValue	False
has_unit	unit	QuantityValue	False
hc_produced	hc_produced_enum	Biosample	False
hcr	hcr_enum	Biosample	False
hcr_fw_salinity	QuantityValue	Biosample	True
hcr_geol_age	hcr_geol_age_enum	Biosample	False
hcr_pressure	TextValue	Biosample	True
hcr_temp	TextValue	Biosample	True
heat_cool_type	heat_cool_type_enum	Biosample	False
heat_deliv_loc	heat_deliv_loc_enum	Biosample	False
heat_sys_deliv_meth	string	Biosample	False
heat_system_id	TextValue	Biosample	True
heavy_metals	TextValue	Biosample	True
heavy_metals_meth	TextValue	Biosample	True
height_carper_fiber	QuantityValue	Biosample	True
herbicide_regm	TextValue	Biosample	True
highest_similarity_score	float	MetaboliteIdentification	False
homepage_website	string	Study	False
horizon_meth	TextValue	Biosample	True
host_age	QuantityValue	Biosample	True
host_body_habitat	TextValue	Biosample	True
host_body_product	ControlledTermValue	Biosample	True
host_body_site	ControlledTermValue	Biosample	True
host_body_temp	QuantityValue	Biosample	True
host_color	TextValue	Biosample	True
host_common_name	TextValue	Biosample	True
host_diet	TextValue	Biosample	True
host_disease_stat	TextValue	Biosample	True
host_dry_mass	QuantityValue	Biosample	True
host_family_relation	string	Biosample	False
host_genotype	TextValue	Biosample	True
host_growth_cond	TextValue	Biosample	True
host_height	QuantityValue	Biosample	True
host_last_meal	TextValue	Biosample	True
host_length	QuantityValue	Biosample	True
host_life_stage	TextValue	Biosample	True
host_name	string	Biosample	False
host_phenotype	ControlledTermValue	Biosample	True
host_sex	host_sex_enum	Biosample	False
host_shape	TextValue	Biosample	True
host_subject_id	TextValue	Biosample	True
host_subspecf_genlin	string	Biosample	False
host_substrate	TextValue	Biosample	True
host_symbiont	string	Biosample	False
host_taxid	ControlledIdentifiedTermValue	Biosample	True
host_tot_mass	QuantityValue	Biosample	True
host_wet_mass	QuantityValue	Biosample	True
humidity	QuantityValue	Biosample	True
humidity_regm	TextValue	Biosample	True
id	uriorcurie	Biosample, CalibrationInformation, ChemicalConversionProcess, ChemicalEntity, ChromatographicSeparationProcess, ChromatographyConfiguration, CollectingBiosamplesFromSite, Configuration, DataGeneration, DataObject, DissolvingProcess, EnvironmentalMaterialTerm, Extraction, FieldResearchSite, FiltrationProcess, FunctionalAnnotationTerm, GeneProduct, InformationObject, Instrument, LibraryPreparation, MagsAnalysis, Manifest, MassSpectrometry, MassSpectrometryConfiguration, MaterialEntity, MaterialProcessing, MetabolomicsAnalysis, MetagenomeAnnotation, MetagenomeAssembly, MetagenomeSequencing, MetaproteomicsAnalysis, MetatranscriptomeAnnotation, MetatranscriptomeAssembly, MetatranscriptomeExpressionAnalysis, MixingProcess, NamedThing, NomAnalysis, NucleotideSequencing, OntologyClass, OrthologyGroup, Pathway, PlannedProcess, Pooling, ProcessedSample, ReadBasedTaxonomyAnalysis, ReadQcAnalysis, Sample, Site, StorageProcess, Study, SubSamplingProcess, WorkflowExecution	False
igsn_biosample_identifiers	external_identifier	Biosample	False
img_identifiers	external_identifier	Biosample, MagsAnalysis, MetagenomeAnnotation, MetatranscriptomeAnnotation, MetatranscriptomeExpressionAnalysis	False
in_manifest	Manifest	DataObject	True
indoor_space	indoor_space_enum	Biosample	False
indoor_surf	indoor_surf_enum	Biosample	False
indust_eff_percent	QuantityValue	Biosample	True
infiltrations	string	Biosample	False
inorg_particles	TextValue	Biosample	True
input_base_count	float	ReadQcAnalysis	False
input_contig_num	integer	MagsAnalysis	False
input_mass	QuantityValue	Extraction	True
input_read_bases	float	ReadQcAnalysis	False
input_read_count	float	ReadQcAnalysis	False
insdc_assembly_identifiers	string	MetagenomeAssembly, MetatranscriptomeAssembly	False
insdc_bioproject_identifiers	external_identifier	NucleotideSequencing, Study	False
insdc_biosample_identifiers	external_identifier	Biosample	False
insdc_experiment_identifiers	external_identifier	DataObject, NucleotideSequencing	False
inside_lux	QuantityValue	Biosample	True
instrument_set	Instrument	Database	True
instrument_used	Instrument	ChemicalConversionProcess, ChromatographicSeparationProcess, DataGeneration, DissolvingProcess, Extraction, FiltrationProcess, LibraryPreparation, MassSpectrometry, MaterialProcessing, MixingProcess, NucleotideSequencing, Pooling, SubSamplingProcess	True
int_wall_cond	int_wall_cond_enum	Biosample	False
internal_calibration	boolean	CalibrationInformation	False
investigation field	string	Biosample	False
ionization_source	IonizationSourceEnum	MassSpectrometryConfiguration	False
is_obsolete	boolean	ChemicalEntity, EnvironmentalMaterialTerm, FunctionalAnnotationTerm, OntologyClass, OrthologyGroup, Pathway	False
is_pressurized	boolean	FiltrationProcess	False
is_root	boolean	ChemicalEntity, EnvironmentalMaterialTerm, FunctionalAnnotationTerm, OntologyClass, OrthologyGroup, Pathway	False
is_stranded	boolean	LibraryPreparation	False
isotope_exposure	string	Biosample	False
iw_bt_date_well	TimestampValue	Biosample	True
iwf	QuantityValue	Biosample	True
jgi_portal_study_identifiers	external_identifier	Study	False
known_as	ChemicalEntityEnum	PortionOfSubstance	False
language	language_code	TextValue	False
last_clean	TimestampValue	Biosample	True
lat_lon	GeolocationValue	Biosample, FieldResearchSite	True
latitude	decimal_degree	GeolocationValue	False
lbc_thirty	QuantityValue	Biosample	True
lbceq	QuantityValue	Biosample	True
library_preparation_kit	string	LibraryPreparation	False
library_type	LibraryTypeEnum	LibraryPreparation	False
light_intensity	QuantityValue	Biosample	True
light_regm	TextValue	Biosample	True
light_type	light_type_enum	Biosample	False
link_addit_analys	TextValue	Biosample	True
link_class_info	TextValue	Biosample	True
link_climate_info	TextValue	Biosample	True
lithology	lithology_enum	Biosample	False
local_class	TextValue	Biosample, FieldResearchSite	True
local_class_meth	TextValue	Biosample	True
location	string	Biosample	False
longitude	decimal_degree	GeolocationValue	False
low_depth_contig_num	integer	MagsAnalysis	False
magnesium	QuantityValue	Biosample	True
mags_list	MagBin	MagsAnalysis	True
manganese	QuantityValue	Biosample	True
manifest_category	ManifestCategoryEnum	Manifest	False
manifest_set	Manifest	Database	True
mass	QuantityValue	PortionOfSubstance, SubSamplingProcess	True
mass_analyzers	MassAnalyzerEnum	MassSpectrometryConfiguration	False
mass_spectrometry_acquisition_strategy	MassSpectrometryAcquisitionStrategyEnum	MassSpectrometryConfiguration	False
mass_spectrum_collection_modes	MassSpectrumCollectionModeEnum	MassSpectrometryConfiguration	False
material_processing_set	MaterialProcessing	Database	True
max_occup	QuantityValue	Biosample	True
md5_checksum	string	DataObject	False
mean_frict_vel	QuantityValue	Biosample	True
mean_peak_frict_vel	QuantityValue	Biosample	True
mech_struc	mech_struc_enum	Biosample	False
mechanical_damage	TextValue	Biosample	True
members_id	string	MagBin	False
metabolite_identified	string	MetaboliteIdentification	False
metabolomics_analysis_category	MetabolomicsAnalysisCategoryEnum	MetabolomicsAnalysis	False
metaproteomics_analysis_category	MetaproteomicsAnalysisCategoryEnum	MetaproteomicsAnalysis	False
methane	QuantityValue	Biosample	True
mgnify_project_identifiers	external_identifier	Study	False
micro_biomass_c_meth	string	Biosample	False
micro_biomass_meth	string	Biosample	False
micro_biomass_n_meth	string	Biosample	False
microbial_biomass	QuantityValue	Biosample	True
microbial_biomass_c	string	Biosample	False
microbial_biomass_n	string	Biosample	False
mineral_nutr_regm	TextValue	Biosample	True
misc_param	TextValue	Biosample	True
mod_date	string	Biosample, DataGeneration, MassSpectrometry, NucleotideSequencing	False
model	InstrumentModelEnum	Instrument	False
n_alkanes	TextValue	Biosample	True
name	string	Biosample, CalibrationInformation, ChemicalConversionProcess, ChemicalEntity, ChromatographicSeparationProcess, ChromatographyConfiguration, CollectingBiosamplesFromSite, Configuration, DataGeneration, DataObject, DissolvingProcess, EnvironmentalMaterialTerm, Extraction, FieldResearchSite, FiltrationProcess, FunctionalAnnotationTerm, GeneProduct, InformationObject, Instrument, LibraryPreparation, MagsAnalysis, Manifest, MassSpectrometry, MassSpectrometryConfiguration, MaterialEntity, MaterialProcessing, MetabolomicsAnalysis, MetagenomeAnnotation, MetagenomeAssembly, MetagenomeSequencing, MetaproteomicsAnalysis, MetatranscriptomeAnnotation, MetatranscriptomeAssembly, MetatranscriptomeExpressionAnalysis, MixingProcess, NamedThing, NomAnalysis, NucleotideSequencing, OntologyClass, OrthologyGroup, Pathway, PersonValue, PlannedProcess, Pooling, ProcessedSample, Protocol, ReadBasedTaxonomyAnalysis, ReadQcAnalysis, Sample, Site, StorageProcess, Study, SubSamplingProcess, WorkflowExecution	False
ncbi_lineage	string	EukEval	False
ncbi_lineage_tax_ids	string	EukEval	False
ncbi_project_name	string	NucleotideSequencing	False
ncbi_taxonomy_name	string	Biosample	False
neon_biosample_identifiers	external_identifier	Biosample	False
neon_study_identifiers	external_identifier	Study	False
nitrate	QuantityValue	Biosample	True
nitrate_nitrogen	QuantityValue	Biosample	True
nitrite	QuantityValue	Biosample	True
nitrite_nitrogen	QuantityValue	Biosample	True
nitro	QuantityValue	Biosample	True
non_microb_biomass	string	Biosample	False
non_microb_biomass_method	string	Biosample	False
non_min_nutr_regm	string	Biosample	False
notes	string	Study	False
nucl_acid_amp	TextValue	LibraryPreparation	True
nucleic acid sequence source field	string	Biosample	False
num_16s	integer	MagBin	False
num_23s	integer	MagBin	False
num_5s	integer	MagBin	False
num_aligned_reads	float	MetagenomeAssembly, MetatranscriptomeAssembly	False
num_input_reads	float	MetagenomeAssembly, MetatranscriptomeAssembly	False
num_t_rna	integer	MagBin	False
number_of_contig	integer	MagBin	False
number_pets	QuantityValue	Biosample	True
number_plants	QuantityValue	Biosample	True
number_resident	QuantityValue	Biosample	True
object	OntologyClass	OntologyRelation	True
objective	string	Study	False
occup_density_samp	QuantityValue	Biosample	True
occup_document	occup_document_enum	Biosample	False
occup_samp	QuantityValue	Biosample	True
orcid	string	PersonValue	False
ordered_mobile_phases	MobilePhaseSegment	ChromatographicSeparationProcess, ChromatographyConfiguration	True
org_carb	QuantityValue	Biosample	True
org_count_qpcr_info	string	Biosample	False
org_matter	QuantityValue	Biosample	True
org_nitro	QuantityValue	Biosample	True
org_nitro_method	string	Biosample	False
org_particles	TextValue	Biosample	True
organism_count	QuantityValue	Biosample	True
other_treatment	string	Biosample	False
output_base_count	float	ReadQcAnalysis	False
output_read_bases	float	ReadQcAnalysis	False
output_read_count	float	ReadQcAnalysis	False
owc_tvdss	QuantityValue	Biosample	True
oxy_stat_samp	oxy_stat_samp_enum	Biosample	False
oxygen	QuantityValue	Biosample	True
part_of	FieldResearchSite	FieldResearchSite	True
part_of	Study	Study	True
part_org_carb	QuantityValue	Biosample	True
part_org_nitro	QuantityValue	Biosample	True
particle_class	TextValue	Biosample	True
pcr_cond	TextValue	LibraryPreparation	True
pcr_cycles	integer	LibraryPreparation	False
pcr_primers	TextValue	LibraryPreparation	True
permeability	TextValue	Biosample	True
perturbation	TextValue	Biosample	True
pesticide_regm	TextValue	Biosample	True
petroleum_hydrocarb	QuantityValue	Biosample	True
ph	double	Biosample	False
ph_meth	TextValue	Biosample	True
ph_regm	TextValue	Biosample	True
phaeopigments	TextValue	Biosample	True
phase	integer	GenomeFeature	False
phosphate	QuantityValue	Biosample	True
phosplipid_fatt_acid	TextValue	Biosample	True
photon_flux	QuantityValue	Biosample	True
plant_growth_med	ControlledTermValue	Biosample	True
plant_product	TextValue	Biosample	True
plant_sex	plant_sex_enum	Biosample	False
plant_struc	ControlledTermValue	Biosample	True
polarity_mode	PolarityModeEnum	MassSpectrometryConfiguration	False
pollutants	TextValue	Biosample	True
porosity	TextValue	Biosample	True
potassium	QuantityValue	Biosample	True
pour_point	QuantityValue	Biosample	True
pre_treatment	TextValue	Biosample	True
predicate	OntologyClass	OntologyRelation	True
pres_animal_insect	string	Biosample	False
pressure	QuantityValue	Biosample	True
prev_land_use_meth	string	Biosample	False
previous_land_use	TextValue	Biosample	True
primary_prod	QuantityValue	Biosample	True
primary_treatment	TextValue	Biosample	True
principal_investigator	PersonValue	DataGeneration, MassSpectrometry, NucleotideSequencing, Study	True
processed_sample_set	ProcessedSample	Database	True
processing_institution	ProcessingInstitutionEnum	ChemicalConversionProcess, ChromatographicSeparationProcess, CollectingBiosamplesFromSite, DataGeneration, DissolvingProcess, Extraction, FiltrationProcess, LibraryPreparation, MagsAnalysis, MassSpectrometry, MaterialProcessing, MetabolomicsAnalysis, MetagenomeAnnotation, MetagenomeAssembly, MetagenomeSequencing, MetaproteomicsAnalysis, MetatranscriptomeAnnotation, MetatranscriptomeAssembly, MetatranscriptomeExpressionAnalysis, MixingProcess, NomAnalysis, NucleotideSequencing, PlannedProcess, Pooling, ReadBasedTaxonomyAnalysis, ReadQcAnalysis, StorageProcess, SubSamplingProcess, WorkflowExecution	False
prod_rate	QuantityValue	Biosample	True
prod_start_date	TimestampValue	Biosample	True
profile_image_url	string	PersonValue	False
profile_position	profile_position_enum	Biosample	False
project_id	string	Biosample	False
proport_woa_temperature	string	Biosample	False
proposal_dna	string	Biosample	False
proposal_rna	string	Biosample	False
protocol_link	Protocol	ChemicalConversionProcess, ChromatographicSeparationProcess, CollectingBiosamplesFromSite, DataGeneration, DissolvingProcess, Extraction, FiltrationProcess, LibraryPreparation, MagsAnalysis, MassSpectrometry, MaterialProcessing, MetabolomicsAnalysis, MetagenomeAnnotation, MetagenomeAssembly, MetagenomeSequencing, MetaproteomicsAnalysis, MetatranscriptomeAnnotation, MetatranscriptomeAssembly, MetatranscriptomeExpressionAnalysis, MixingProcess, NomAnalysis, NucleotideSequencing, PlannedProcess, Pooling, ReadBasedTaxonomyAnalysis, ReadQcAnalysis, StorageProcess, Study, SubSamplingProcess, WorkflowExecution	True
qc_comment	string	ChemicalConversionProcess, ChromatographicSeparationProcess, CollectingBiosamplesFromSite, DataGeneration, DissolvingProcess, Extraction, FiltrationProcess, LibraryPreparation, MagsAnalysis, MassSpectrometry, MaterialProcessing, MetabolomicsAnalysis, MetagenomeAnnotation, MetagenomeAssembly, MetagenomeSequencing, MetaproteomicsAnalysis, MetatranscriptomeAnnotation, MetatranscriptomeAssembly, MetatranscriptomeExpressionAnalysis, MixingProcess, NomAnalysis, NucleotideSequencing, PlannedProcess, Pooling, ReadBasedTaxonomyAnalysis, ReadQcAnalysis, StorageProcess, SubSamplingProcess, WorkflowExecution	False
qc_failure_what	FailureWhatEnum	FailureCategorization	False
qc_failure_where	FailureWhereEnum	FailureCategorization	False
qc_status	StatusEnum	ChemicalConversionProcess, ChromatographicSeparationProcess, CollectingBiosamplesFromSite, DataGeneration, DissolvingProcess, Extraction, FiltrationProcess, LibraryPreparation, MagsAnalysis, MassSpectrometry, MaterialProcessing, MetabolomicsAnalysis, MetagenomeAnnotation, MetagenomeAssembly, MetagenomeSequencing, MetaproteomicsAnalysis, MetatranscriptomeAnnotation, MetatranscriptomeAssembly, MetatranscriptomeExpressionAnalysis, MixingProcess, NomAnalysis, NucleotideSequencing, PlannedProcess, Pooling, ReadBasedTaxonomyAnalysis, ReadQcAnalysis, StorageProcess, SubSamplingProcess, WorkflowExecution	False
quad_pos	quad_pos_enum	Biosample	False
radiation_regm	TextValue	Biosample	True
rainfall_regm	TextValue	Biosample	True
reactor_type	TextValue	Biosample	True
redox_potential	QuantityValue	Biosample	True
rel_air_humidity	QuantityValue	Biosample	True
rel_humidity_out	QuantityValue	Biosample	True
rel_samp_loc	rel_samp_loc_enum	Biosample	False
related_identifiers	string	Study	False
relations	OntologyRelation	ChemicalEntity, EnvironmentalMaterialTerm, FunctionalAnnotationTerm, OntologyClass, OrthologyGroup, Pathway	True
replicate_number	string	Biosample	False
reservoir	TextValue	Biosample	True
resins_pc	TextValue	Biosample	True
resolution_categories	ResolutionCategoryEnum	MassSpectrometryConfiguration	False
rna_absorb1	float	Biosample	False
rna_absorb2	float	Biosample	False
rna_collect_site	string	Biosample	False
rna_concentration	float	Biosample	False
rna_cont_type	JgiContTypeEnum	Biosample	False
rna_cont_well	string	Biosample	False
rna_container_id	string	Biosample	False
rna_isolate_meth	string	Biosample	False
rna_organisms	string	Biosample	False
rna_project_contact	string	Biosample	False
rna_samp_id	string	Biosample	False
rna_sample_format	RNASampleFormatEnum	Biosample	False
rna_sample_name	string	Biosample	False
rna_seq_project	string	Biosample	False
rna_seq_project_name	string	Biosample	False
rna_seq_project_pi	string	Biosample	False
rna_volume	float	Biosample	False
room_air_exch_rate	QuantityValue	Biosample	True
room_architec_elem	string	Biosample	False
room_condt	room_condt_enum	Biosample	False
room_connected	room_connected_enum	Biosample	False
room_count	TextValue	Biosample	True
room_dim	TextValue	Biosample	True
room_door_dist	TextValue	Biosample	True
room_door_share	TextValue	Biosample	True
room_hallway	TextValue	Biosample	True
room_loc	room_loc_enum	Biosample	False
room_moist_dam_hist	integer	Biosample	False
room_net_area	TextValue	Biosample	True
room_occup	QuantityValue	Biosample	True
room_samp_pos	room_samp_pos_enum	Biosample	False
room_type	room_type_enum	Biosample	False
room_vol	TextValue	Biosample	True
room_wall_share	TextValue	Biosample	True
room_window_count	integer	Biosample	False
root_cond	TextValue	Biosample	True
root_med_carbon	TextValue	Biosample	True
root_med_macronutr	TextValue	Biosample	True
root_med_micronutr	TextValue	Biosample	True
root_med_ph	QuantityValue	Biosample	True
root_med_regl	TextValue	Biosample	True
root_med_solid	TextValue	Biosample	True
root_med_suppl	TextValue	Biosample	True
salinity	QuantityValue	Biosample	True
salinity_category	string	Biosample	False
salinity_meth	TextValue	Biosample	True
salt_regm	TextValue	Biosample	True
samp_capt_status	samp_capt_status_enum	Biosample	False
samp_collec_device	string	Biosample	False
samp_collec_method	string	Biosample	False
samp_collect_point	samp_collect_point_enum	Biosample	False
samp_dis_stage	samp_dis_stage_enum	Biosample	False
samp_floor	samp_floor_enum	Biosample	False
samp_loc_corr_rate	TextValue	Biosample	True
samp_mat_process	ControlledTermValue	Biosample	True
samp_md	QuantityValue	Biosample	True
samp_name	string	Biosample	False
samp_preserv	TextValue	Biosample	True
samp_room_id	TextValue	Biosample	True
samp_size	QuantityValue	Biosample	True
samp_sort_meth	TextValue	Biosample	True
samp_store_dur	TextValue	Biosample	True
samp_store_loc	TextValue	Biosample	True
samp_store_temp	QuantityValue	Biosample	True
samp_subtype	samp_subtype_enum	Biosample	False
samp_taxon_id	ControlledIdentifiedTermValue	Biosample	True
samp_time_out	TextValue	Biosample	True
samp_transport_cond	TextValue	Biosample	True
samp_tvdss	TextValue	Biosample	True
samp_type	TextValue	Biosample	True
samp_weather	samp_weather_enum	Biosample	False
samp_well_name	TextValue	Biosample	True
sample_collection_site	string	Biosample	False
sample_link	string	Biosample	False
sample_shipped	string	Biosample	False
sample_state_information	SampleStateEnum	PortionOfSubstance	False
sample_type	SampleTypeEnum	Biosample	False
sampled_portion	SamplePortionEnum	SubSamplingProcess	False
saturates_pc	TextValue	Biosample	True
scaf_bp	float	MetagenomeAssembly, MetatranscriptomeAssembly	False
scaf_l50	float	MetagenomeAssembly, MetatranscriptomeAssembly	False
scaf_l90	float	MetagenomeAssembly, MetatranscriptomeAssembly	False
scaf_l_gt50k	float	MetagenomeAssembly, MetatranscriptomeAssembly	False
scaf_logsum	float	MetagenomeAssembly, MetatranscriptomeAssembly	False
scaf_max	float	MetagenomeAssembly, MetatranscriptomeAssembly	False
scaf_n50	float	MetagenomeAssembly, MetatranscriptomeAssembly	False
scaf_n90	float	MetagenomeAssembly, MetatranscriptomeAssembly	False
scaf_n_gt50k	float	MetagenomeAssembly, MetatranscriptomeAssembly	False
scaf_pct_gt50k	float	MetagenomeAssembly, MetatranscriptomeAssembly	False
scaf_powsum	float	MetagenomeAssembly, MetatranscriptomeAssembly	False
scaffolds	float	MetagenomeAssembly, MetatranscriptomeAssembly	False
season	TextValue	Biosample	True
season_environment	TextValue	Biosample	True
season_precpt	QuantityValue	Biosample	True
season_temp	QuantityValue	Biosample	True
season_use	season_use_enum	Biosample	False
secondary_treatment	TextValue	Biosample	True
sediment_type	sediment_type_enum	Biosample	False
separation_method	SeparationMethodEnum	FiltrationProcess	False
seqid	string	GenomeFeature	False
sequencing field	string	Biosample	False
sewage_type	TextValue	Biosample	True
shad_dev_water_mold	string	Biosample	False
shading_device_cond	shading_device_cond_enum	Biosample	False
shading_device_loc	TextValue	Biosample	True
shading_device_mat	TextValue	Biosample	True
shading_device_type	shading_device_type_enum	Biosample	False
sieving	TextValue	Biosample	True
silicate	QuantityValue	Biosample	True
size_frac	TextValue	Biosample	True
size_frac_low	QuantityValue	Biosample	True
size_frac_up	QuantityValue	Biosample	True
slope_aspect	QuantityValue	Biosample	True
slope_gradient	QuantityValue	Biosample	True
sludge_retent_time	QuantityValue	Biosample	True
sodium	QuantityValue	Biosample	True
soil_horizon	soil_horizon_enum	Biosample	False
soil_text_measure	QuantityValue	Biosample	True
soil_texture_meth	string	Biosample	False
soil_type	TextValue	Biosample, FieldResearchSite	True
soil_type_meth	TextValue	Biosample	True
solar_irradiance	QuantityValue	Biosample	True
soluble_inorg_mat	TextValue	Biosample	True
soluble_iron_micromol	string	Biosample	False
soluble_org_mat	TextValue	Biosample	True
soluble_react_phosp	QuantityValue	Biosample	True
source_concentration	QuantityValue	PortionOfSubstance	True
source_mat_id	TextValue	Biosample	True
space_typ_state	TextValue	Biosample	True
specific	specific_enum	Biosample	False
specific_ecosystem	string	Biosample, Study	False
specific_humidity	QuantityValue	Biosample	True
sr_dep_env	sr_dep_env_enum	Biosample	False
sr_geol_age	sr_geol_age_enum	Biosample	False
sr_kerog_type	sr_kerog_type_enum	Biosample	False
sr_lithology	sr_lithology_enum	Biosample	False
standing_water_regm	TextValue	Biosample	True
start	integer	GenomeFeature	False
start_date	string	ChemicalConversionProcess, ChromatographicSeparationProcess, CollectingBiosamplesFromSite, DataGeneration, DissolvingProcess, Extraction, FiltrationProcess, LibraryPreparation, MagsAnalysis, MassSpectrometry, MaterialProcessing, MetabolomicsAnalysis, MetagenomeAnnotation, MetagenomeAssembly, MetagenomeSequencing, MetaproteomicsAnalysis, MetatranscriptomeAnnotation, MetatranscriptomeAssembly, MetatranscriptomeExpressionAnalysis, MixingProcess, NomAnalysis, NucleotideSequencing, PlannedProcess, Pooling, ReadBasedTaxonomyAnalysis, ReadQcAnalysis, StorageProcess, SubSamplingProcess, WorkflowExecution	False
start_date_inc	string	Biosample	False
start_time_inc	string	Biosample	False
started_at_time	string	MagsAnalysis, MetabolomicsAnalysis, MetagenomeAnnotation, MetagenomeAssembly, MetagenomeSequencing, MetaproteomicsAnalysis, MetatranscriptomeAnnotation, MetatranscriptomeAssembly, MetatranscriptomeExpressionAnalysis, NomAnalysis, ReadBasedTaxonomyAnalysis, ReadQcAnalysis, WorkflowExecution	False
stationary_phase	StationaryPhaseEnum	ChromatographicSeparationProcess, ChromatographyConfiguration	False
storage_process_set	StorageProcess	Database	True
store_cond	TextValue	Biosample	True
strand	string	GenomeFeature	False
stranded_orientation	StrandedOrientationEnum	LibraryPreparation	False
study_category	StudyCategoryEnum	Study	False
study_image	ImageValue	Study	True
study_set	Study	Database	True
subject	GeneProduct	FunctionalAnnotation	True
subject	OntologyClass	OntologyRelation	True
substance_role	SubstanceRoleEnum	PortionOfSubstance	False
substances_used	PortionOfSubstance	ChemicalConversionProcess, DissolvingProcess, Extraction, MobilePhaseSegment, StorageProcess	True
substances_volume	QuantityValue	ChemicalConversionProcess	True
substructure_type	substructure_type_enum	Biosample	False
subsurface_depth	QuantityValue	Biosample	True
sulfate	QuantityValue	Biosample	True
sulfate_fw	QuantityValue	Biosample	True
sulfide	QuantityValue	Biosample	True
surf_air_cont	surf_air_cont_enum	Biosample	False
surf_humidity	QuantityValue	Biosample	True
surf_material	surf_material_enum	Biosample	False
surf_moisture	QuantityValue	Biosample	True
surf_moisture_ph	double	Biosample	False
surf_temp	QuantityValue	Biosample	True
suspend_part_matter	QuantityValue	Biosample	True
suspend_solids	TextValue	Biosample	True
tan	QuantityValue	Biosample	True
target_gene	TargetGeneEnum	NucleotideSequencing	False
target_subfragment	TextValue	NucleotideSequencing	True
technical_reps	string	Biosample	False
temp	QuantityValue	Biosample	True
temp_out	QuantityValue	Biosample	True
temperature	QuantityValue	ChemicalConversionProcess, ChromatographicSeparationProcess, ChromatographyConfiguration, DissolvingProcess, StorageProcess, SubSamplingProcess	True
term	OntologyClass	ControlledIdentifiedTermValue, ControlledTermValue	True
tertiary_treatment	TextValue	Biosample	True
tidal_stage	tidal_stage_enum	Biosample	False
tillage	tillage_enum	Biosample	False
tiss_cult_growth_med	TextValue	Biosample	True
title	string	Study	False
toluene	QuantityValue	Biosample	True
too_short_contig_num	integer	MagsAnalysis	False
tot_carb	QuantityValue	Biosample	True
tot_depth_water_col	QuantityValue	Biosample	True
tot_diss_nitro	QuantityValue	Biosample	True
tot_inorg_nitro	QuantityValue	Biosample	True
tot_iron	QuantityValue	Biosample	True
tot_nitro	QuantityValue	Biosample	True
tot_nitro_cont_meth	string	Biosample	False
tot_nitro_content	QuantityValue	Biosample	True
tot_org_c_meth	TextValue	Biosample	True
tot_org_carb	QuantityValue	Biosample	True
tot_part_carb	QuantityValue	Biosample	True
tot_phosp	QuantityValue	Biosample	True
tot_phosphate	QuantityValue	Biosample	True
tot_sulfur	QuantityValue	Biosample	True
total_bases	integer	MagBin	False
train_line	train_line_enum	Biosample	False
train_stat_loc	train_stat_loc_enum	Biosample	False
train_stop_loc	train_stop_loc_enum	Biosample	False
turbidity	QuantityValue	Biosample	True
tvdss_of_hcr_press	QuantityValue	Biosample	True
tvdss_of_hcr_temp	QuantityValue	Biosample	True
typ_occup_density	double	Biosample	False
type	uriorcurie	AttributeValue, Biosample, CalibrationInformation, ChemicalConversionProcess, ChemicalEntity, ChromatographicSeparationProcess, ChromatographyConfiguration, CollectingBiosamplesFromSite, Configuration, ControlledIdentifiedTermValue, ControlledTermValue, CreditAssociation, DataGeneration, DataObject, DissolvingProcess, Doi, EnvironmentalMaterialTerm, EukEval, Extraction, FailureCategorization, FieldResearchSite, FiltrationProcess, FunctionalAnnotation, FunctionalAnnotationAggMember, FunctionalAnnotationTerm, GeneProduct, GenomeFeature, GeolocationValue, ImageValue, InformationObject, Instrument, LibraryPreparation, MagBin, MagsAnalysis, Manifest, MassSpectrometry, MassSpectrometryConfiguration, MaterialEntity, MaterialProcessing, MetaboliteIdentification, MetabolomicsAnalysis, MetagenomeAnnotation, MetagenomeAssembly, MetagenomeSequencing, MetaproteomicsAnalysis, MetatranscriptomeAnnotation, MetatranscriptomeAssembly, MetatranscriptomeExpressionAnalysis, MixingProcess, MobilePhaseSegment, NamedThing, NomAnalysis, NucleotideSequencing, OntologyClass, OntologyRelation, OrthologyGroup, Pathway, PersonValue, PlannedProcess, Pooling, PortionOfSubstance, ProcessedSample, Protocol, QuantityValue, ReadBasedTaxonomyAnalysis, ReadQcAnalysis, Sample, Site, StorageProcess, Study, SubSamplingProcess, TextValue, TimestampValue, WorkflowExecution	False
unbinned_contig_num	integer	MagsAnalysis	False
url	string	DataObject, ImageValue, Protocol	False
uses_calibration	CalibrationInformation	MetabolomicsAnalysis, NomAnalysis	True
vendor	InstrumentVendorEnum	Instrument	False
ventilation_rate	QuantityValue	Biosample	True
ventilation_type	TextValue	Biosample	True
version	string	MagsAnalysis, MetabolomicsAnalysis, MetagenomeAnnotation, MetagenomeAssembly, MetagenomeSequencing, MetaproteomicsAnalysis, MetatranscriptomeAnnotation, MetatranscriptomeAssembly, MetatranscriptomeExpressionAnalysis, NomAnalysis, ReadBasedTaxonomyAnalysis, ReadQcAnalysis, WorkflowExecution	False
vfa	QuantityValue	Biosample	True
vfa_fw	QuantityValue	Biosample	True
vis_media	vis_media_enum	Biosample	False
viscosity	TextValue	Biosample	True
volatile_org_comp	TextValue	Biosample	True
volume	QuantityValue	Extraction, FiltrationProcess, MobilePhaseSegment, PortionOfSubstance, SubSamplingProcess	True
wall_area	QuantityValue	Biosample	True
wall_const_type	wall_const_type_enum	Biosample	False
wall_finish_mat	wall_finish_mat_enum	Biosample	False
wall_height	QuantityValue	Biosample	True
wall_loc	wall_loc_enum	Biosample	False
wall_surf_treatment	wall_surf_treatment_enum	Biosample	False
wall_texture	wall_texture_enum	Biosample	False
wall_thermal_mass	QuantityValue	Biosample	True
wall_water_mold	TextValue	Biosample	True
was_generated_by	MetagenomeAnnotation	FunctionalAnnotation	True
was_generated_by	WorkflowExecution	DataObject, FunctionalAnnotationAggMember	True
was_informed_by	DataGeneration	MagsAnalysis, MetabolomicsAnalysis, MetagenomeAnnotation, MetagenomeAssembly, MetagenomeSequencing, MetaproteomicsAnalysis, MetatranscriptomeAnnotation, MetatranscriptomeAssembly, MetatranscriptomeExpressionAnalysis, NomAnalysis, ReadBasedTaxonomyAnalysis, ReadQcAnalysis, WorkflowExecution	True
wastewater_type	TextValue	Biosample	True
water_cont_soil_meth	string	Biosample	False
water_content	string	Biosample	False
water_current	QuantityValue	Biosample	True
water_cut	QuantityValue	Biosample	True
water_feat_size	QuantityValue	Biosample	True
water_feat_type	water_feat_type_enum	Biosample	False
water_prod_rate	QuantityValue	Biosample	True
water_temp_regm	TextValue	Biosample	True
watering_regm	TextValue	Biosample	True
websites	string	PersonValue, Study	False
weekday	weekday_enum	Biosample	False
win	TextValue	Biosample	True
wind_direction	TextValue	Biosample	True
wind_speed	QuantityValue	Biosample	True
window_cond	window_cond_enum	Biosample	False
window_cover	window_cover_enum	Biosample	False
window_horiz_pos	window_horiz_pos_enum	Biosample	False
window_loc	window_loc_enum	Biosample	False
window_mat	window_mat_enum	Biosample	False
window_open_freq	TextValue	Biosample	True
window_size	TextValue	Biosample	True
window_status	TextValue	Biosample	True
window_type	window_type_enum	Biosample	False
window_vert_pos	window_vert_pos_enum	Biosample	False
window_water_mold	TextValue	Biosample	True
workflow_execution_set	WorkflowExecution	Database	True
xylene	QuantityValue	Biosample	True
zinc	QuantityValue	Biosample	True
